"filename", "language", "JavaScript", "toml", "XML", "SCSS", "comment", "blank", "total"
"c:\Users\Jake\Documents\Github\redditclone\application\frontend\src\Pipfile", "toml", 0, 8, 0, 0, 0, 4, 12
"c:\Users\Jake\Documents\Github\redditclone\application\frontend\src\api-calls\helpers\headerConfig.js", "JavaScript", 9, 0, 0, 0, 0, 3, 12
"c:\Users\Jake\Documents\Github\redditclone\application\frontend\src\api-calls\helpers\loginError.js", "JavaScript", 14, 0, 0, 0, 0, 4, 18
"c:\Users\Jake\Documents\Github\redditclone\application\frontend\src\api-calls\helpers\loginSuccess.js", "JavaScript", 13, 0, 0, 0, 0, 1, 14
"c:\Users\Jake\Documents\Github\redditclone\application\frontend\src\api-calls\requests\createComment.js", "JavaScript", 17, 0, 0, 0, 0, 2, 19
"c:\Users\Jake\Documents\Github\redditclone\application\frontend\src\api-calls\requests\createPost.js", "JavaScript", 17, 0, 0, 0, 0, 2, 19
"c:\Users\Jake\Documents\Github\redditclone\application\frontend\src\api-calls\requests\getPost.js", "JavaScript", 11, 0, 0, 0, 0, 4, 15
"c:\Users\Jake\Documents\Github\redditclone\application\frontend\src\api-calls\requests\getSubredits.js", "JavaScript", 10, 0, 0, 0, 0, 2, 12
"c:\Users\Jake\Documents\Github\redditclone\application\frontend\src\api-calls\requests\getUser.js", "JavaScript", 12, 0, 0, 0, 0, 2, 14
"c:\Users\Jake\Documents\Github\redditclone\application\frontend\src\api-calls\requests\homePosts.js", "JavaScript", 11, 0, 0, 0, 0, 2, 13
"c:\Users\Jake\Documents\Github\redditclone\application\frontend\src\api-calls\requests\logout.js", "JavaScript", 10, 0, 0, 0, 0, 2, 12
"c:\Users\Jake\Documents\Github\redditclone\application\frontend\src\api-calls\requests\postComment.js", "JavaScript", 22, 0, 0, 0, 0, 4, 26
"c:\Users\Jake\Documents\Github\redditclone\application\frontend\src\api-calls\requests\postSubreddit.js", "JavaScript", 15, 0, 0, 0, 0, 3, 18
"c:\Users\Jake\Documents\Github\redditclone\application\frontend\src\api-calls\requests\putVote.js", "JavaScript", 21, 0, 0, 0, 0, 5, 26
"c:\Users\Jake\Documents\Github\redditclone\application\frontend\src\api-calls\requests\registerUser.js", "JavaScript", 17, 0, 0, 0, 0, 3, 20
"c:\Users\Jake\Documents\Github\redditclone\application\frontend\src\api-calls\requests\subredditPosts.js", "JavaScript", 13, 0, 0, 0, 0, 2, 15
"c:\Users\Jake\Documents\Github\redditclone\application\frontend\src\api-calls\requests\userLogin.js", "JavaScript", 13, 0, 0, 0, 0, 3, 16
"c:\Users\Jake\Documents\Github\redditclone\application\frontend\src\assets\images\up-arrow.svg", "XML", 0, 0, 1, 0, 0, 0, 1
"c:\Users\Jake\Documents\Github\redditclone\application\frontend\src\components\App.js", "JavaScript", 78, 0, 0, 0, 0, 10, 88
"c:\Users\Jake\Documents\Github\redditclone\application\frontend\src\components\CreateSubreddit.js", "JavaScript", 27, 0, 0, 0, 0, 5, 32
"c:\Users\Jake\Documents\Github\redditclone\application\frontend\src\components\Home.js", "JavaScript", 48, 0, 0, 0, 0, 11, 59
"c:\Users\Jake\Documents\Github\redditclone\application\frontend\src\components\Loading.js", "JavaScript", 4, 0, 0, 0, 0, 2, 6
"c:\Users\Jake\Documents\Github\redditclone\application\frontend\src\components\Subreddit.js", "JavaScript", 53, 0, 0, 0, 0, 11, 64
"c:\Users\Jake\Documents\Github\redditclone\application\frontend\src\components\Wrapper.js", "JavaScript", 26, 0, 0, 0, 0, 2, 28
"c:\Users\Jake\Documents\Github\redditclone\application\frontend\src\components\accounts\Login.js", "JavaScript", 44, 0, 0, 0, 0, 6, 50
"c:\Users\Jake\Documents\Github\redditclone\application\frontend\src\components\accounts\Register.js", "JavaScript", 75, 0, 0, 0, 0, 8, 83
"c:\Users\Jake\Documents\Github\redditclone\application\frontend\src\components\layouts\Alerts.js", "JavaScript", 13, 0, 0, 0, 0, 4, 17
"c:\Users\Jake\Documents\Github\redditclone\application\frontend\src\components\layouts\Header.js", "JavaScript", 108, 0, 0, 0, 0, 11, 119
"c:\Users\Jake\Documents\Github\redditclone\application\frontend\src\components\posts\components\CommentForm.js", "JavaScript", 73, 0, 0, 0, 0, 9, 82
"c:\Users\Jake\Documents\Github\redditclone\application\frontend\src\components\posts\components\Comments.js", "JavaScript", 65, 0, 0, 0, 0, 5, 70
"c:\Users\Jake\Documents\Github\redditclone\application\frontend\src\components\posts\components\PostTopRow.js", "JavaScript", 30, 0, 0, 0, 0, 3, 33
"c:\Users\Jake\Documents\Github\redditclone\application\frontend\src\components\posts\components\VoteButton.js", "JavaScript", 74, 0, 0, 0, 0, 12, 86
"c:\Users\Jake\Documents\Github\redditclone\application\frontend\src\components\posts\components\VoteScoreWrapper.js", "JavaScript", 34, 0, 0, 0, 0, 3, 37
"c:\Users\Jake\Documents\Github\redditclone\application\frontend\src\components\posts\components\down-arrow.js", "JavaScript", 17, 0, 0, 0, 0, 2, 19
"c:\Users\Jake\Documents\Github\redditclone\application\frontend\src\components\posts\components\up-arrow.js", "JavaScript", 17, 0, 0, 0, 0, 2, 19
"c:\Users\Jake\Documents\Github\redditclone\application\frontend\src\components\posts\pages\CreatePost.js", "JavaScript", 58, 0, 0, 0, 0, 10, 68
"c:\Users\Jake\Documents\Github\redditclone\application\frontend\src\components\posts\pages\Post.js", "JavaScript", 132, 0, 0, 0, 0, 16, 148
"c:\Users\Jake\Documents\Github\redditclone\application\frontend\src\components\posts\pages\Posts.js", "JavaScript", 61, 0, 0, 0, 0, 8, 69
"c:\Users\Jake\Documents\Github\redditclone\application\frontend\src\components\posts\pages\posts.scss", "SCSS", 0, 0, 0, 97, 0, 14, 111
"c:\Users\Jake\Documents\Github\redditclone\application\frontend\src\components\posts\updateCommentTree.js", "JavaScript", 43, 0, 0, 0, 0, 5, 48
"c:\Users\Jake\Documents\Github\redditclone\application\frontend\src\components\styles.scss", "SCSS", 0, 0, 0, 170, 0, 30, 200
"c:\Users\Jake\Documents\Github\redditclone\application\frontend\src\context\GlobalContext.js", "JavaScript", 2, 0, 0, 0, 0, 2, 4
"c:\Users\Jake\Documents\Github\redditclone\application\frontend\src\context\initialState.js", "JavaScript", 18, 0, 0, 0, 0, 4, 22
"c:\Users\Jake\Documents\Github\redditclone\application\frontend\src\index.js", "JavaScript", 1, 0, 0, 0, 0, 1, 2
"Total", "-", 1326, 8, 1, 267, 0, 244, 1846